aguantar = to endure
un ricachón = a very rich man
más vale tarde que nunca = better late than never
nunca más = never again
nunca jamás = never again
para/por siempre jamás = forever
para/por siempre = forever
letras de canciones = song lyrics
Y así lo hizo. = And he did so.
Cuando estaba anocheciendo = When it was getting dark
el sol se escondía <br>tras la arboleda = the sun hid <br>behind the trees
Escondida tras del árbol = hidden behind a tree
no era sino un anciano = was nothing but an old
hechizo = spell
campo de amapolas = poppy fields
lo que deseaban = what they wanted
de hacer realidad sus deseos = to make the dreams come through
quería ser valiente = wanted to be brave
asustado con los ladridos = frightened by the barking
baldosas amarillas = yellow bricks
hada = fairy
tentativa de huida = attempted escape
estoy deseando verte = I'm looking forward to seeing you
el deseo = desire
¡ni un carajo! = no way!, hell no!
me importa un carajo = I don't give a damn
¡No entiendes un carajo! = You don't know a f.ing s..t!
meramente expresar fastidio = merely express annoyance
ras de canciones = song lyrics
emplear = employ<sup>1</sup>, use<sup>2</sup>
Eso no te lo crees ni tú = ~I don't believe you
sé valiente, siquiera sea por una vez = be brave at least once
No como ni duermo = I don't eat or sleep
anglohablante = English-speaking
Es poco lo que te conozco = I hardly know you
tercera edad = elderly
consecuencias inimaginables = unimaginable consequences
que han roto una regla = who broke a rule
desafío = challenge
construir una amistad = build a friendship
encabezado por una mujer = lead by a woman
¡pero que les das! = what (potion) did you give him!(?)
¡que linda eres! = how pretty you are!
nalgas = buttocks
llovía, pero fuimos a dar un paseo = it was raining but we went for a walk
¿Pero tú estás loca? = are you crazy?
la chufa = tiger nut, earth almond
chulo (adj) = neat, cute (Mex)
el chulo = show-off, [insolente, fanfarrón]
el bombero = fireman
atrapar = to trap, to catch
la porqueria = bullshit
¿Tienes una pistola? = Do you have a gun?
¡Para inmediatamente! (imp.) = Stop immediately!
el espejo = mirror
usa el sentido comun = use common sense
un incendio provocado = arson
robo armado = armed robbery
asaltar autos = car-jacking
si sigues estos consejos, estarás bien = you'll be Ok if you follow my advice
no se parece a nada = there's nothing like it
Perra vida = Dog's life
lo contrario = the opposite
no tirar piedras! = don't throw stones!
estilo de vida = lifestyle
infelicidad y melancolía = unhappiness or melancholy
un pedazo de pan = piece of bread
la escopeta = shotgun
poco cerebro = small brain
mazas y palos = clubs and sticks
lo que más me molesta<br>lo que más me inquieta = What worries me most
técnicas punteras de diseño = cutting-edge design techniques
nada que añadir = nothing to add
puede tener sentido + inf = could make sense to..
El fontanero cobra mucho = The plumber charges much
no bloqueen la entrada = don't block the entrance
La cerveza más barata = the cheapest beer
está muy satisfecho = is very satisfied
La ventaja de saber español = The advantage of knowing Spanish
¡Prohibido mear! = Peeing not allowed!
morder (muerde) = to bite
gracias por adelantado = thanks in advance
buzón = mailbox
Tus ojos son preciosos = Your eyes are beautiful
He visto tus ojos = I saw your eyes
Tal vez yo deba comenzar = myabe I should start
tus labios = your lips
Que yo sepa (subjunctive) = as far as I know
una mancha negra = a black spot
llamada para el <br>señor Zentero = a call for Sr Zentero
el fracaso = failure
afeitar = shave
el extranjero = alien, foreigner
se acabaron sus aventuras = your adventure is finished
acabar = finish
puesto de mando = command post
muy agotado = very tired
el agotamiento = exhaustion, tiredness
no pude = I couldn't do it
todas la medidas <br>de seguridad = all security measures
ya debería estar acá = should already be here
guagua (Cuba,Can.) = bus
el niñito = toddler
el nene = baby boy
¿Cuáles serían sus planes? = what are your plans?
no sufrió bajas = did not suffer losses
el sentido de la palabra = the meaning of the word
aunque<sup>1</sup> = though, although
bienestar = welfare
poner en peligro = put in danger
news = noticias, nuevas
desconocer totalmente = to be blissfully unaware
la lamentable noticia = the sad news
la fuente = source
las fuentes de suministro = sources of subsistence
mano duro = firm hand
fuente de ingreso = source of income
además = moreover
Me chocó = I was surprised
un delgadísimo = very thin person
familia de bajos recursos = poor family
los niños se burlaran de mí = children made fun of me
rédito económico = economic revenue
¿Algo caro no? = a bit expensive, isn't it?
nos estamos alejandos = we are isolated
rodear = encircle
¿Qué sugiere? = What do you suggest?
tomar medidas = take measures
van a entra en huelga = will go on strike
estar en las últimas = is about to die soon
Eso no es una mala idea = this is not a bad idea
Ustedes no tienen <br>el derecho a... = you don't have <br>the right to...
la bandera blanca = white flag
el cabrón, la cabra = goat (also, traitor, bastard)
a toda costa (fem.) = at any price
adelantar = advance, progress, forego
el cojudo = idiot
la gallina = chicken
choclo = corn, maize
el cerdo, el puerco <br>el chancho (LatAm.) = pig
Cabeza de cerdo = Hog's head
A cada cerdo le llega <br>su San Martin = Every dog will <br>have its day
los campesinos = peasants, countrymen
nomás = only
todo es mentira = all is a lie
primero que nada = first of all
lo que es aún peor = what's even worse...
ir aún más lejos = go + a/one step further
desarrollar aún más = develop further
aún peor = even worse
aún más = all the more
aún entonces = even then
aun cuando = even though
aún así = even so
molestar = <sup>1</sup>to worry, <sup>2</sup>to offend
la molestia = trouble, nuisance, worry
el fastidio = annoyance, boredom
jodido (vulg.) = fucked/fucked up
ponlos a secar = put them to dry
empapado de agua = soaked with water
cualquier movimiento que hagamos = every move we make
la guía = guide
la guerra = war
pidría llevar dos meses = could take two months
creo que deberías esperar = I think you should wait
puedes caer preso = you can get into jail
eso digo! = that's my point!
su alta mando = your high command
en todo nivel = at all levels
eso toma tiempo = it takes time
no se quiso quedar ninguno = nobody wanted to stay
me voy a retirar <br>del ejército = i will retire from army
nosotros estamos comprometidos = we are involved
tienda de abarrotes, <br>la pulpería (LatA) = grosery store
es un mentiroso! = he is a liar!
son unos cobardes = are cowards
rendir = give over, surrender
nos rendimos = we surrender
No me queda bien = it does not suit me
No te queda mal = It does <i>not</i> look bad (on you)
Quedamos a las ocho = We’re meeting at eight o’clock.
No quedaron en nada = They didn’t agree on anything
Quedemos en vernos el jueves = Let’s meet on Thursday
Hemos quedado <br>en ir al cine  = We’ve agreed  <br>to go to the cinema
Me quedé en casa = I stayed at home
Se quedan con sus amigos = They are staying with their friends
quedar<sup>2</sup> = to arrange to meet
la emboscada = ambush
la plata = silver, money
el carajo = prick (vulg.)
acercar = to approach
¿Tuvieron algún problemas? = did you have problems?
acá = here, over here
salir al amanecer = leave early (at dawn)
para cerrar = at the end (of a speech)
después será tarde = afterwards will be too late
veo que están atareados/ocupados = I can see you are busy
muéstreme la casa = show me the house
la belleza = beauty
lindo = nice
está lindo el cuento = it's a nice story
para cazar = for hunting
el cazador = hunter
la pereza = laziness
sacudir las plumas = ruffle the feathers
callado = silent
pagará con su vida = will pay with his/her life
traicionar = betray
(la) harina de trigo = flour
la huelga = job strike
los campesinos que <br>viven en esa zona = peasants who live <br>in that area
allí la vida es dura = life there is hard
triturar las hojas = smush the leaves
aconsejar = advise, suggest
necesito que alguien me aconseje = I need some advice
el partido no <b><i>apoya</i></b>  <br>la lucha armada = the party does not <br><b><i>support</i></b> armed battle
a fin de cuentas = in the long run
tarea = task, assignment, homework, job
La belleza no lo és todo = Beauty is not everything
disfrazar = to disguise
un hombre zafio y ordinario = a coarse and ordinary man
una persona grosera = a rude person
sin educación = uneducated
chantajista = blackmailer
¿Qué es lo que se <br>quiere decir con esto? = What is the <br>meaning of this?
desatento = thoughtless, inconsiderate
patán disfrazado de un caballero = redneck disguised as gentelman
una jugada sucia = dirty trick
descortés (adj.) = rude, impolite, ill-mannered
meterse en problemas = get into trouble
una especial habilidad <br>para meterse en problemas = a speical ability to <br>get into trouble
su función es muy sencilla = it's easy to work with it
propósito = intent, mission, point, purpose
a propósito de = with regard to
de propósito = on purpose
impresor = printer
de igual a igual = as equals
la desvergüenza = shamelessness
con desverguenza viola la ley = shamelessly violate the law
¡Obedece la ley! = Obey the law!
desvergonzado = shameless
lograr = to reach
la pelea = fight
el desfile = parade
inmisericorde = merciless, pitiless
aflorar = emerge, reveal
intentar ahorrar dinero = trying to save money
comprar un teléfono móvil = buy a mobile phone
recoger sellos = collect stamps
la broma = joke
no está de broma = no kidding
aportaciones = contributions
el matiz = nuance
cursi = corny
sería entre lo más normal = would be ok
me ha sido de gran ayuda = it was very helpful
fingiendo = pretending
le quita el móvil = takes away the mobile
la albahaca = basil
apunta = write down
el vientre = belly
muy divertido = very funny
serio = serious
delante de sus hijos = in front of his sons
detras = behind
atacar por detras = to attack from behind
sobre = above
arriba = over, up, upstairs
dentro = inside
encima de = above the
por debajo = below
casi todos = almost all
desde arriba = from above
la hoja = leaf
el nieve = snow
el invierno = winter
el otoño = automn
morado = violet
la mayoria = majority
el lado = side, part
cruzar el puente = cross the bridge
la puesta de sol = sunset
la silla = chair
la pared = wall
deslizar = slide, slip
la valla = hurdle
el ternero = calf
atar = to tie
la pluma = feather
levantar = wake up
obrar = to act, to operate, to work
la obra = work, effort
Roma fue saqueada = Rome was plundered
los godos = the Goths
moro = Northern African arab
se quedó tan deslumbrado = was so impressed
lugarteniente = deputy
arrancar = rip off
una pata = paw <font size="-1">(pie de mueble)</font>
un espejo = mirror
un aleación = alloy
la redecilla = net
la cuna de niño = cradle
extraviar = mislead
asustar = to frighten
la hormiga = the ant
el zorro = fox, shrewd person
postor = bidder, buyer 
herido/herida = wounded, injured

