# converted from mnemosyne file for Spanish Vocabulary, uploaded by Larry Renslow source URL: http://www.mnemosyne-proj.org/files/SpanishVocabulary.zip
la ardilla = squirrel 
el avestruz = ostrich 
el koala = koala 
la vaca = cow 
la vibora = snake 
el avellano = rabbit 
el pato = duck 
el caballo = horse 
la tortuga = turtle 
la oveja = sheep 
el oso = bear 
el rinoceronte = rhino 
el lobo = wolf 
el erizo = hedgehog 
la jirafa = giraffe 
la cabra = goat 
el pez = fish 
la gaviota = gull 
el leon pequeño = small lion 
la mariposa = butterfly 
el dinosaurio = dinosaur 
la rana = frog 
el pavo real = peacock 
el gato = cat 
el ciervo = deer 
el gorrion = sparrow 
el cisne = swan 
la hiena = hyena 
el grajo = crow 
el calzoncillo = parrot 
el elefante = elephant 
la foca = seal 
el pingüino = penguin 
la hormiga = ant 
el raton = mouse 
el tigre = tiger 
la abeja = bee 
el delfin = doplhin 
el abubilla comun = hoopoe 
la pava = goose 
la estrige = owl 
el gallo = cock 
la gallina = hen 
la manzana = apple 
la naranja = orange 
el vestido = dress 
el mueble = furniture 
el taladro = drill 
la campana = bell 
la lampara = lamp 
la palma = palm 
la ciruela = plum 
la rosa = rose 
el zapato = shoe 
la pena = feather 
la barca = boat 
la peña = rock 
los paraguas = umbrella 
el albaricoque = apricot 
la maleta = suitcase 
la camisa = shirt 
la raqueta = racket 
los huevos = eggs 
el tomate = tomato 
el anteojo = binoculars 
el marco = frame 
el pegameno = glue 
el televisor = TV 
el libro = book 
la escoba = broom 
el limon = lemon 
la banana = banana 
la cebolla = onion 
la piña = pineapple 
la fruta = fruit 
la cara = face 
el cipres = cypress 
el yate = yacht 
la silla = chair 
el jeque = sheikh 
el halcon = falcon 
ser brillante = shining 
el desierto = desert 
cazar = to hunt 
la caza = hunter 
ser sabio = trained 
la caza = hunt 
acostumbrarse = to get used to 
estar de pie = to stand 
la hombro = shoulder 
el dueño = owner 
descubrir = to behold 
el zorro = fox 
precipitarse en = to bear down 
si = if 
destrozar = to rupture 
el piel = coat 
porque = so that 
poder = to can 
vender = to sell 
el precio = price 
encontrar = to find 
algun = any 
sentir = to feel 
la fatiga = fatigue 
porque = because 
el calor = heat 
violento = heavy 
salir = to run out 
la agua = water 
ser forzado = to be forced to 
iniciar = to begin 
el viaje = journey 
el regreso = return 
durante = during 
ir = to go 
alto = high 
mirar = to look at 
la gota = drop 
entonces = then 
alegrarse = to enjoy 
el hato = amount 
recogerse = to concentrate 
la fosa = pit 
aquellos = those 
tomar = to take 
el cobre = copper 
utilizar = to use 
esperar = to wait 
volar = to fly 
circular = to circle 
el aire = air 
incrementar = to proliferate 
cargar = to fill up 
querer = to want 
elevar = to upraise 
algo = something 
suceder = to happen 
peculiar = weird 
ya = already 
rapido = fast 
la crueldad = cruelty 
batir = to beat 
el ala = wing 
caer = to fall 
la mano = hand 
derramar = to leak 
la arena = sand 
la actitud = attitude 
tonto = stupid 
sediento = thirsty 
la sed = thirst 
robar = to rob 
poner = to deposit 
una vez = once 
colectar = to collect 
la boca = mouth 
la colera = anger 
el nervio = nerve 
contener = to control oneself 
agarrar = to catch 
la escopeta = rifle 
la bala = bullet 
herir = to hit 
la sangre = blood 
fluir = to flow 
loco = crazy 
doblar = to knuckle down 
buscar = to search 
el sitio = place 
enfardarse = to get angry 
pensar sobre = to think 
el medio = instrument 
escalar = to climb 
subir = to go up 
pensar = to think 
usar = to use 
el esfuerzo = effort 
el fin = end 
soportar = to suffer 
sufrir = to suffer 
la alegria = to lavish onjoy 
mirar a = to look at 
amedrentar = to scare 
ver = to see 
venenoso = poisonous 
muerto = dead 
el veneno = poison 
mezclar = to mix 
coger = to comprehend 
mortal = deadly 
salvar = to rescue 
la muerte = death 
seguro = sure 
llamar = to shout 
fiel = loyal 
correr = to hurry 
bajar = to walk down 
trasladarse = to betake 
ofendido = injured 
presionar = to push 
el pecho = breast 
errar = to mistake 
el veredicto = judgment 
enseñar = to teach 
la fidelidad = loyalty 
olvidar = to forget 
el bolso = bag 
el vendaje = bandage 
vendaje = to bandage 
el brazo = arm 
volver = to return 
vivir = to live 
con = with 
los padres = parents 
la selva = forest 
desamparar = to leave 
la ratonera = mousehole 
salir = to exit 
temprano = early 
la red = net 
verde = green 
soleado = sunny 
colorido = coloured 
correr = to run 
subito = suddenly 
ahuyentar = to chase away 
en todas partes = everywhere 
sedarse = to sit down 
la cosa = thing 
saber = to know 
antes = before 
cuidar = to watch 
probar = to try 
pero = but 
el manotazo = slap 
excitarse = to fuss 
la nariz = nose 
gritar = to bawl 
la voz = voice 
clamar = to scream 
el bribon = rapscallion 
a = on 
hacer = to do 
miserable = lousy 
el cuello = neck 
agitar = to shake 
temblar = to tremble 
el miedo = fear 
decir = to say 
fenomenal = brilliant 
matar = to kill 
insignificante = insignificant 
flojo = weak 
piadoso = merciful 
quizas = perhaps 
ayudar = to help 
reir = to laugh 
la palabra = word 
ironico = ironically 
el rey = king 
avecinar = to near 
quitarse = to leave 
tirar = to pull 
poder = to can 
morder = to bite 
el diente = tooth 
el animal = animal 
sacar = to fetch 
el peligro = danger 
oir = to hear 
largo = long 
el mono = monkey 
el ave = bird 
tener miedo = to fear 
callar = to be silent 
la labor = work 
el mugido = roar 
escuchar = to listen 
de verdad = truly 
amigo = friend 
picante = hot 
nunca = never 
la diligencia = diligence 
cortar = to cut 
causar = to cause 
la apertura = opening 
libre = free 
desde = since 
tornar = to become 
amar = to love 
cooperar = to collaborate 
reacio = bullheaded 
el burro = donkey 
el pueblo = village 
el padre = father 
la madre = mother 
el panadero = baker 
guardar = to herd 
coger = to take 
el sueño = sleep 
la tarde = evening 
pasar = to spend 
rechazar = to refuse 
permanecer = to stay 
empujar = to push 
ultimo = last 
rebullir = to move 
ponerse = to set 
el sol = sun 
la noche = night 
tener sueño = to be tired 
tener ganas = to thirst 
tener hambre = to hunger 
al lado de = beside 
triste = sad 
afligir = to mourn 
llorar = to cry 
inquietar = to trouble 
jugar = to play 
los arboles = trees 
preguntar = to ask 
la cabeza = head 
las lagrimas = tears 
el cachete = cheek 
contar = to tell 
la narracion = story 
levantar = to rise 
inmediatamente = immediately 
ir = to go 
reclamar = to demand 
haragan = lazy 
la tierra = earth 
apatico = apathetic 
desesperar = to despair 
la visita = visit 
la finca = farm 
vecino = nearby 
hablar con = to speak to 
explicar = to explain 
la razon = cause 
el asunto = concern 
simple = easy 
muy = very 
aterrar = to frighten 
regañar = to snarl 
el canino = canine 
cuidar = to care 
la amenaza = menace 
pero = but 
girar = to turn 
la espalda = back 
la ofensa = offence 
despues = after 
nuevo = new 
aspirar = to suck 
la flora = flower 
el nectar = nectar 
fabricar = to make 
la miel = honey 
dedicarse a = to be busy 
marvillar = to wonder about 
ganar = to earn 
todos = all 
engreido = vain 
dificil = difficult 
meñique = tiny 
dedicar = to turn to 
la mirla = ear 
cerrar = to close 
el ojo = eye 
la direccion = direction 
picar = to sting 
saltar = to jump 
la pierna = leg 
la vista = view 
durar = to last 
hasta = until 
llegar = to arrive 
el camino = way 
el soberano = sovereign 
acostarse = to lay down 
perder = to disappear 
jurar = to swear 
arrepentirse = to regret 
la jura = oath 
ligar = to bind 
bañar = to bath 
el rio = river 
mudar = to undress 
la ribera = shore 
nadar = to swim 
el ladron = thief 
robar = to steal 
nudista = naked 
la casa = house 
mojar = to get wet 
el cuerpo = body 
creer = to believe 
la concubina = secondary wife 
dar = to donate 
el collar = necklace 
impartir = to impart 
reunir = to congress 
contentar = to be satisfied 
el cariño = darling 
peer = to fart 
avergonzar = to be ashamed 
el escaño = bench 
de madera = wooden 
fingir = to drownto pretend 
mas bien = rather 
la madera = wood 
el olor = odour 
aportar = to bring 
el albañil = bricklayer 
construir = to build 
el aseo = toilet 
el dormitorio = dorm 
el comedor = dining room 
el vestibulo = lobby 
el tabique = shed 
el establo = barn 
fetido = fetid 
pelear = to dispute 
la persona = person 
donde = where 
el juez = judge 
el demandador = claimant 
la carga = burden 
pesado = heavy 
pagar = to pay 
nada = nothing 
la exigencia = demand 
correcto = correct 
el mendigo = beggar 
rico = rich 
tener = to own 
el palacio = palace 
el sirviente = servant 
el donativo = donation 
la terraza = terrace 
ponerse negro = to huff 
el cielo = sky 
haber = to get 
el anima = soul 
arrogante = arrogant 
venir = to come 
cualquier dia = someday 
la oficina = office 
el escritor = writer 
la biblioteca = library 
la clase = class 
el profesor = teacher 
el cole = school 
viajar = to travel 
el embajador = ambassador 
el viajante = traveller 
la embajada = embassy 
fraccionario = broken 
la rotura = break 
romper = to break 
el cascanueces = nutcracker 
el jugador = player 
el parque = playground 
el juego = game 
la mesa = table 
el coche = car 
la enfermera = nurse 
la puella = girl 
Egipto = Egypt 
la hermana = sister 
el chico = boy 
Irak = Iraq 
la calle = road 
la imagen = picture 
el mitin = meeting 
la cama = bed 
la llave = key 
el bolígrafo = pen 
la breva = fig 
la tienda = tent 
el perro = dog 
el contable = accountant 
el ingeniero = engineer 
el carpintero = carpenter 
la botella = bottle 
el idioma = language 
el refrigerador = fridge 
el telefono = telephone 
el computador = computer 
bello = beautiful 
feo = ugly 
antiguo = old 
aereo = light 
grande = big 
pequeño = small 
breve = short 
feliz = happy 
illustre = famous 
casado = married 
propio = suitable 
el periodico = newspaper 
rojo = red 
azul = blue 
amarillo = yellow 
negro = black 
blanco = white 
a la izquierda = left 
a la derecha = right 
la banca = bank 
el ministro = minister 
dulce = sweet 
escribir = to write 
asiatico = asian 
el desastre = disaster 
la maquina = machine 
automatico = automatic 
ahora = now 
la señorita = lady 
demostrar = to verify 
responder = to answer 
la paga = fee 
el alquiler = hire 
el porte = postage 
realizar = to perform 
extranjero = foreign 
conseguir = to achieve 
quemar = to burn 
a veces = sometimes 
el hermano = brother 
mudo = mute 
el utensilio = gear 
la literatura = literature 
inferior = down 
guiar = to lead 
informar = to notify 
retraer = to return 
hachemi = jordanian 
enviar = to send 
mostrar = to show 
la crisis = crisis 
el fundamento = fundament 
fundamental = basic 
la semana = week 
el profesor = professor 
marron = brown 
vigilar = to supervise 
rubio = blond 
el origen = origin 
original = original 
adicionar = to add 
sordo = deaf 
la disertacion = dissertation 
notificar = to inform 
restablecer = to renew 
admirar = to admire 
dar = to give 
seguir = to follow 
anunciar = to announce 
ciego = blind 
la cancion = song 
alegrar = to delight 
el horizonte = horizon 
organizar = to hold 
lejano = far 
asegurar = to ensure 
comer = to eat 
la comida = food 
cancelar = to cancel 
mil = thousand 
echar = to throw 
el dolor = pain 
aleman = german 
Alemania = Germany 
ante = in front 
seguridad = security 
la gente = folk 
la America = America 
americano = american 
ayer = yesterday 
esperar = to hope 
el emir = emir 
el cajero = cashier 
el secretario = secretary 
el tubo = pipe 
producir = to produce 
acabar = to finish 
la familia = Sunnisfamily 
la importancia = import 
forzar = to force 
europeo = european 
encomendar = to recommend 
apostillar = to elucidate 
enviar = to delegate 
primero = first 
apoyar = to support 
tambien = too 
etnologico = ethnologic 
las vacaciones = holidays 
la administracion = administration 
castellano = spanish 
España = Spain 
la diarrea = diarrhoea 
la contribucion = contribution 
la extension = spread 
la inclusion = inclusion 
el dedo = finger 
la reforma = reform 
la preparación = preparation 
la información = information 
africano = african 
la bancarrota = bankruptcy 
la estancia = stay 
feudal = feudal 
la divinidad = divinity 
el emirato = emirate 
el imperio = empire 
la posibilidad = chance 
la produccion = production 
el humano = human 
humano = human 
la pulgada = inch 
la justicia = justice 
el gasto = expenses 
la influenza = influenza 
positivo = positive 
Iran = Iran 
Italia = Italy 
sonreir = to smile 
la invencion = invention 
el hijo = son 
acudir = to turn 
la union = union 
el mitin = congregation 
reunir = to meet 
necesitar = to need 
cuidar = to respect 
la festividad = festivity 
guardar = to keep 
ocupar = to occupy 
la reserva = reserve 
seleccionar = to choose 
el test = test 
terminar = to abandon 
desaparecer = to disappear 
la altitud = height 
la satisfaccion = satisfaction 
subir = to increase 
el alza = improvement 
florar = to bloom 
alquilar = to rent 
el boletin = blank 
explotar = to exploit 
excluir = to exclude 
la utilizacion = use 
extraer = to carry 
deducir = to derive 
descansar = to rest 
estrategico = strategic 
el orientalismo = orientalism 
durar = to last 
la explotacion = exploitation 
beneficiar = to profit 
la pregunta = question 
la bienvenida = greeting 
dar la bienvenida = to greet 
la estabilidad = stability 
la independencia = independence 
persistir = to continue 
la continuidad = continuity 
el consumo = consumption 
importar = to import 
la importacion = import 
el nombre = name 
el socialista = socialist 
el socialismo = socialism 
participar = to participate 
trabajar = to work 
el estorbo = error 
basarse en algo = to be based on 
la apertura = opening 
el polifacetismo = variety 
la oferta = recommendation 
proponer = to recommend 
partir = to share 
la economia = economy 
economico = economic 
economica politica = national economy 
la obligacion = debt 
extender = to range 
la señora = woman 
haber de = to be to do 
la productividad = productivity 
la eleccion = election 
la victoria = victory 
reanimar = to revive 
terminar = to end 
la calma = stagnation 
la depresion = descent 
concordar = to consort 
retaer = to retrieve 
celebrar = to hold 
golpe de estado = coup 
la decadencia = decay 
el pozo = font 
infeliz = unhappy 
el vendedor = vendor 
la puerta = door 
el papa = Dad 
Babilonia = Babylon 
el investigador = researcher 
las berenjenas = aubergines 
voladizo = outstanding 
constante = always 
el bus = bus 
usado = outworn 
mear = to piddle 
seguramente = surely 
justo = exact 
considerable = considerable 
tanto por ciento = percent 
referente = concerning 
brillante = shiny 
petroquimico = petrochemical 
el petroleo = petrol 
discutir = to argue 
la investigacion = research 
el marinero = sailor 
la marina = marine 
segun = according to 
el incienso = incense 
parecer = to seem 
el principio = beginning 
substituir = to replace 
el traje = suit 
los beduinos = bedouins 
sustituto = replacement 
sembrar = to seed 
la semilla = seed 
la rectitud = honesty 
Portugal = Portugal 
el frio = cold 
frio = cold 
justificar = to justify 
aperecer = to emerge 
la bendicion = mercy 
parlamentario = parliamentary 
la barrica = barrel 
el programa = program 
el protocolo = protocol 
Gran Bretaña = Great Britain 
exponer = to expose 
la mercaderia = shrewdware 
la lentitud = slowness 
la bateria = battery 
las patatas = potatoes 
el billete = ticket 
la capa = blanket 
el vientre = stomach 
el campeonato = championship 
lento = slow 
las sandias = watermelons 
pasado mañana = day after tomorrow 
algunos = some 
el mercader = trader 
ganado vacuno = cattle 
el bote = tip 
el resto = rest 
el bachillerato = A-levels 
sin = without 
inutil = useless 
indudable = doubtless 
plastico = plastics 
Belgica = Belgium 
el pais = country 
totalizar = to amount 
el balcon = balcony 
promedio = average 
la construccion = construction 
la casa = building 
constructivo = constructive 
la gasolina = fuel 
el pantalon = trousers 
el portero = concierge 
el orin = urine 
Polonia = Poland 
la birra = beer 
entre = between 
muerto = dead 
la influencia = influence 
el corrimiento = shift 
consistir = to be made up of 
el seguro = insurance 
la calificacion = qualification 
la ayuda = help 
la fecha = date 
todo = whole 
el cambio = exchange 
rivalizar = to rival 
la señal = omen 
pertenecer = to belong 
el comercio = trade 
la renovacion = renewal 
fosilizar = to lithify 
el desafio = challenge 
la mejora = improvement 
el control = control 
el analisis = analysis 
entusiasmar = to get into 
la transferencia = transfer 
el saludo = salute 
absolver = to graduate 
especialization = specialization 
la reduccion = reduction 
desmoronar = to decay 
acordarse = to recall 
el heredero = heritage 
oscilar = to range between 
la educacion = education 
traducir = to translate 
la traduccion = translation 
Turquia = Turkey 
la estructura = structure 
la purificacion = lustration 
la inscripcion = enrolment 
la aceleracion = acceleration 
el marketing = marketing 
el asesoramiento = advice 
formar = to form 
la figuracion = creation 
la exportacion = export 
la autentificacion = authentication 
comportar = to behave 
la explicacion = explanation 
la calificacion = qualification 
el reparo = repair 
necesitar = to demand 
el desarrollo = development 
la cooperativa = collective 
cansado = tired 
el asombro = amazement 
juntar = to be linked up 
aprender = to learn 
superar = to overcome 
alterar = to change 
la interaccion = interaction 
mirar = to watch 
el detalle = detail 
por favor = please 
la particion = split 
el progreso = progress 
la estima = approximation 
aproximadamente = circa 
el reporte = report 
tradicional = traditional 
tecnico = technical 
la tecnica = technic 
el calendario = calendar 
la evaluacion = evaluation 
el refuerzo = enhancement 
la tecnologia = technology 
telefonear = to phone 
gozar = to relish 
crear = to create 
la extension = extension 
el ejercicio = exercise 
el tenis = tennis 
la organizacion = organisation 
la diversificacion = diversification 
el suspenso = pressure 
la distribucion = distribution 
la unificacion = association 
la ampliacion = expansion 
la encomienda = recommendation 
la facilitacion = allocation 
el acierto = success 
esperar = to await 
depender = to depend 
la firma = signing 
encargar = to take over 
Tunez = Tunisia 
segundo = second 
secundario = secondary 
la riqueza = wealth 
cultural = cultural 
treinta = thirty 
el tercio = third 
la nieve = snow 
bilateral = bilateral 
la revolucion = revolution 
el ajo = garlic 
el galardon = award 
premio Nobel = Nobel prize 
el vecino = neighbour 
arido = to be alloweddry 
la mezquita = mosque 
la universita = university 
la pagina = page 
pelear con = to try for 
equipar = to equip 
la montaña = mountain 
el queso = cheese 
el frontal = forehead 
la pared = wall 
la brega = brawl 
la utilidad = gain 
fundamental = fundamental 
las medias = stockings 
el tractor = tractor 
probar = to fit 
el camarero = waiter 
la parte = part 
Argelia = Algeria 
la isla = island 
enorme = huge 
el arroyo = stream 
la bola = sphere 
el cuero = leather 
sentar = to sit 
la belleza = beauty 
el camello = camel 
el publico = audience 
la republica = republic 
cortejo funebre = funeral cortege 
el radio = poundradio 
la repuesta = answer 
el pasaporte = passport 
las nueces = nuts 
hambriento = hungry 
viaje circular = round trip 
el ente = essence 
bueno = good 
el ejercito = army 
la generacion = generation 
geologico = geologic 
el peregrino = pilgrim 
la ceja = eyebrow 
la demand = need 
caliente = hot 
el calculador = calculator 
el sentido = sense 
la presencia = presence 
presente = present 
rapido = adroit 
imposibilitar = to avoid 
el estado = condition 
preñado = pregnant 
la pastilla = pill 
el melon = melon 
la tinta = ink 
abisinio = abyssinian 
la piedra = stone 
encargar = to order 
la circunferencia = circumference 
restringir = to confine 
la frontera = border 
el filo = sharpness 
el evento = event 
definir = to define 
moderno = modern 
el jardin = garden 
cauto = careful 
el cuidado = attention 
la guerra civil = civil war 
la guerra = war 
liberar = to free 
la letra = letter 
la mocion = movement 
la libertad = freedom 
el partido = party 
la cuenta = bill 
la sensibilidad = sensitivity 
envidiar = to envy 
cosechar = to harvest 
la alcazaba = fortress 
la civilizacion = civilisation 
la prohibicion = prohibition 
la conversacion = conservation 
la hospitalidad = hospitality 
la fiesta = festival 
la cena = dinner 
el derecho = right 
realizar = to realize 
la jeringa = injection 
la verdad = truth 
el poder = power 
el arbitro = referee 
el gobierno = gouvernment 
la solucion = solution 
el peluquero = hairdresser 
el afeitado = shave 
permitido = allowed 
el ensueño = dream 
el postre = dessert 
la joya = jewel 
la leche = milk 
la campaña = campaign 
la fiebre = ague 
el centeno = rye 
el dialogo = dialogue 
la pelvis = pelvis 
vivo = alive 
la vida = life 
el tiempo = time 
vital = vital 
el extranjero = abroad 
el exterior = external 
especial = special 
sincero = sincere 
la noticia = news 
la experiencia = experience 
el pan = bread 
el experto = expert 
prestacion de servicio = service 
la ruina = ruin 
el Jartum = Khartoum 
materia fecal = faeces 
el otoño = autumn 
el armario = cupboard 
la ceramica = ceramic 
guardar = to save 
fertil = fertile 
la fertilidad = fertility 
el rival = rival 
la verdura = vegetable 
el ecuador = equator 
la linea = line 
el habla = speach 
el plan = plan 
la peligrosidad = dangerousness 
peligroso = dangerous 
aliviar = to ease 
el vinagre = vinegar 
el califato = caliphate 
el golfo = gulf 
el califa = caliph 
los pepinos = cucumber 
el circulo = circle 
el interior = interior 
el ayuntamiento = town hall 
la editorial = publisher 
calido = warm 
preparar = to prepare 
diplomatico = diplomatic 
el ave = fowl 
entrar = to enter 
fumar = to smoke 
la bicicleta = bike 
el estudio = study 
la clase = class 
el grado Celsius = degree Celsius 
estudiar = to study 
la leccion = lesson 
la constitucion = constitution 
invitar = to invite 
el invitacion = invitation 
la defensa = defence 
la exactitud = accuracy 
la harina = flour 
el minuto = minute 
la tienda = shop 
el doctor = doctor 
el doctorado = doctorate 
la prueba = proof 
Dinamarca = Denmark 
el medicamento = medicament 
el continuo = continuity 
los gusanos = worms 
el rodillo = roll 
el piso = floor 
la olimpiada = olympiad 
la ronda = round 
el dolar = dollar 
el estado = state 
internacional = international 
el diesel = diesel 
la disoteca = disco 
democratico = democratic 
la democracia = democracy 
la religion = religion 
el dinar = dinar 
religioso = religious 
el maiz = corn 
la barbilla = chin 
la barba = beard 
el pene = penis 
la memoria = memory 
dorado = golden 
dirigir = to direct 
el capitalismo = capitalism 
el pulmon = lung 
el presidente = president 
excelente = excellent 
los haberes = earnings 
la calma = calm 
el pastor = shepherd 
el pasajero = passenger 
ama de casa = housewife 
el ama = mistress 
el cuarto = quarter 
la primavera = spring 
largo = large 
apiadar = to have pity
la piedad = pity 
el permiso = permission 
barato = cheap 
la reaccion = reaction 
el arroz = rice 
la carta = letter 
la tarifa = rate 
oficial = official 
el ministro = legate 
el cohecho = bribe 
sabio = bright 
el plomo = lead 
la columna = column 
desear = to wish 
la regalia = rack 
la prosperidad = prosperity 
el rechazo = rejection 
la subida = increase 
bailar = to dance 
el baile = dance 
el numero = number 
record = record 
la rodilla = knee 
estancar = to stagnate 
la lanza = spear 
el simbolo = symbol 
la novela = novel 
ruso = russian 
Rusia = Russia 
romano = roman 
el riego = irrigation 
el cinc = zinc 
las nupcias = wedding 
el marido = husband 
la mujer = wife 
surtir = to supply 
el aceite = oil 
las olivas = to oilolives 
el deporte = sport 
el deportista = sportsmen 
la matematica = maths 
el viento = wind 
campesino = rural 
mas = plus 
el bastimento = provisions 
visitar = to visit 
el rincon = corner 
la mantequilla = butter 
la agricultura = agriculture 
agricola = agricultural 
plantar = to plant 
la decision = decision 
pitar = to hoot 
el colega = fellow 
el turista = tourist 
el conductor = driver 
antes = former 
la hour = hour 
la pierna = shank 
conducir = to control 
toxico = poisonous 
semitico = semitic 
aportar = to aid 
la carrera = race 
el secreto = secret 
secreto = secret 
la velocidad = velocity 
Arabia Saudi = Saudi Arabia 
la nave = ship 
el hundimiento = breakup 
azucar = sugar 
habitar = to dwell 
la cuchilla = knife 
el arma = weapon 
la paz = peace 
el bienestar = welfare 
negativo = negative 
la canasta = basket 
la ensalada = salad 
el sultanato = sultanate 
traspasar = to deliver 
la escala = stairs 
pacifico = peaceful 
salo = sane 
el abono = dung 
el auricular = headphones 
gordo = thick 
la sunna = Sunna 
el año = year 
el llano = level 
el supermercado = supermarket 
Sudan = Sudan 
Siria = Syria 
sirio = syrian 
el mercado = market 
Suecia = sweden 
Suiza = Switzerland 
turistico = touristy 
la politica = politics 
politico = political 
el cigarrillo = cigarette 
la biografia = biography 
el dominio = dominion 
la avenida = flood 
extenso = spacious 
listo = clever 
el poeta = poet 
general = global 
el sha = shah 
el testigo = witness 
el te = tea 
la ventana = window 
el espectro = ghost 
similar = similar 
el invierno = winter 
diferente = different 
el insulto = cuss 
bravo = brave 
el fervor = ferocity 
la compra = buy 
la bebida = beverage 
bebir = to drink 
la condicion = condition 
la policia = police 
el honor = honour 
oriental = oriental 
la empresa = company 
la cuadrilla = group 
popular = popular 
el pelo = hair 
el rito = ritual 
el labio = lip 
el apartamento = flatlet 
la duda = doubt 
las gracias = thank 
agradecer = to thank 
la forma = form 
el norte = north 
el atestado = report 
el mes = month 
la sopa = soup 
la bielda = fork 
el cheque = cheque 
el salon = hall 
ayunar = to fast 
la mañana = morning 
el salud = health 
el periodista = journalist 
higienico = hygienic 
la cefalea = headache 
exportar = to export 
la amistad = friendship 
la pugna = fight 
la andana = row 
la cualidad = quality 
la oracion = prayer 
la autorizacion = authorisation 
pertinaz = insitent 
orar = to pray 
la industria = industry 
la caja = chest 
la fabricacion = assembly 
el ayuno = abstinence 
Somalia = Somalia 
el boticario = pharmacist 
la farmacia = pharmacy 
el verano = summer 
chino = chinese 
la cercania = neighboorhoud 
el daño = damage 
la presion = pressure 
la garantía = warranty 
la caucion = bail 
la luz = light 
la perdida = loss 
perder = to lose 
el convidado = guest 
angosto = narrow 
volante = flying 
el avion = aeroplane 
el natural = character 
fresco = fresh 
la energia = energy 
el estudiante = student 
la medicina = medicine 
el cocinero = cook 
la clase = class 
el medico = doctor 
la naturaleza = nature 
la comida = meal 
el niño = child 
el tiempo = weather 
el ruego = plea 
desarrollar = to develop 
la arcilla = clay 
el mediodia = midday 
normal = normal 
el amador = lover 
el temporal = storm 
la capital = capital 
el cientifico = scientist 
el mundo = world 
publico = public 
el siglo = century 
tratar = to treat 
el obrero = worker 
el esclavo = slave 
expresar = to express 
osmanli = ottoman 
la inhabilidad = incapability 
el anciano = doter 
el milagro = wonder 
contar = to count 
las lentejas = lentils 
el enemigo = enemy 
iraqui = iraqi 
arabe = arab 
la oferta = offer 
ofrecer = to offer 
la novia = bride 
el novio = groom 
militar = military 
casual = accidental 
la epoca = epoch 
el zumo = juice 
el brazo = upper arm 
el socio = member 
el organo = organ 
el hueso = bone 
el valor = size 
ideologico = ideologic 
la decada = decade 
el escorpion = scorpion 
la mente = mind 
optimo = optimal 
la mentalidad = mentality 
la confesion = confession 
el contra = contrary 
reflejar = to reflect 
la relacion = relationship 
la ciencia = science 
cientifico = scientific 
Oman = Oman 
Amman = Amman 
la edad = age 
la labor = work 
gigante = giant 
la moneda = currency 
el raquis = spine 
el decano = dean 
profundo = deep 
las uvas = grapes 
la araña = spider 
el titulo = title 
el consultorio = medical practice 
dia festivo = holiday 
escurrirse = to seep away 
caro = expensive 
dominante = dominant 
la mayoria = majority 
el polvo = dust 
el cuarto = room 
asaltar = to raid 
la gacela = gazelle 
el asalto = raid 
el error = error 
cantar = to sing 
la presa = theft 
claro = light 
el caballero = equestrian 
la diferencia = difference 
vencer = to win 
pocho = foul 
superar = to outperform 
el fax = fax 
el abridor = opener 
abrir = to open 
inmaduro = unripe 
los rabanos = radish 
la fresa = strawberry 
inqurir = to check 
la investigacion = inquiry 
la vulva = vulva 
los Persas = Persians 
la brocha = brush 
Francia = France 
frances = french 
depravar = to deprave 
fallar = to fail 
la estacion = season 
el escandalo = scandal 
los hongos = mushrooms 
el desayuno = breakfast 
efectivo = effective 
pobre = poor 
el maxilar = jaw 
la ideologia = ideology 
la idea = idea 
el patán = redneck, lout, unrefined 
palestino = palestinian 
la pimienta = pepper 
la pelicula = movie 
el arte = art 
la taza = cup 
el hotel = hotel 
Finlandia = Finland 
entender = to understand 
el fosfato = phosphate 
las judias = beans 
el visado = visa 
la fisica = physics 
la avenida = flood 
fenicio = phoenician 
el mapa = map 
el continente = continent 
claro = explicit 
la regla = rule 
la caravana = caravan 
la teja = brick 
la estatura = figure 
el diccionario = dictionary 
la ley = law 
resistir = to resist 
la cupula = dome 
la gorra = cap 
la tribu = tribe 
el mechero = lighter 
evaluar = to rate 
el destino = destiny 
leer = to read 
decidir = to decide 
el disco = discus 
el pariente = relative 
el coliflor = cauliflower 
presto = soon 
la seccion = section 
pretender = to purpose 
el problema = problem 
el tren = train 
el sector = sector 
la pieza = piece 
el algodon = cotton 
el guante = glove 
el bote = jump 
el corazon = heart 
raro = rare 
poco = few 
la cima = top 
el trigo = wheat 
la luna = moon 
el satelite = satellite 
la bomba = bomb 
el consul = consul 
el cafe = coffee 
fuerzas armadas = armed forces 
la palabra = word 
la gente = people 
fuerte = strong 
en comparacion = comparative 
valioso = precious 
el valor = value 
el cristal = glass 
la calamidad = catastrophe 
ser = to be 
el azufre = sulphur 
el catalogo = catalogue 
silenciar = to conceal 
la duna = dune 
el alcohol = alcohol 
la pocha = lie 
el cuaderno = book 
el baloncesto = basketball 
el voleibol = volleyball 
el futbol = soccer 
el balon = ball 
odiar = to hate 
manifestar = to unveil 
la torta = cake 
facultad = faculty 
la iglesia = church 
la colera = cholera 
Kuwait = Kuwait 
el saco = bag 
el kilo = kilo 
la quimica = chemistry 
Kenia = Kenya 
notar = to note 
vestir = to dress 
Lebano = Lebanon 
la comision = committee 
el instante = jiffy 
la carne = meat 
sabroso = tasty 
la lengua = tongue 
amable = friendly 
la maldicion = curse 
la filologia = philology 
el dios = god 
el dialecto = dialect 
la tabla = blackboard 
las almendras = almonds 
el color = colour 
Libia = Libya 
el minarete = minaret 
usual = common 
la conferencia = conference 
el historiador = historian 
el parametro = parameter 
provisorio = provisional 
el autor = author 
equivaler = to equal 
el pasado = past 
la posesion = property 
financiero = financial 
la Hacienda = finance 
habil = skilled 
bendito = blessed 
directo = direct 
el principio = principle 
la suma = sum 
el museo = museum 
bajo = low 
el sinonimo = synonym 
ascendente = rising 
soler = to be used to 
variable = variable 
la alteracion = change 
el espectador = spectator 
ideal = ideal 
el proverbio = proverb 
el cumplido = compliment 
la sociedad = society 
diligente = diligent 
la gloria = glory 
Hungria = Hungary 
la revista = magazine 
la junta = council 
el complejo = complex 
desconocido = unknown 
el debate = parley 
el docente = lecturer 
la ponencia = lecture 
el distrito = district 
el intento = try 
apreciado = honoured 
probablemente = probably 
el arado = fixedplough 
la parada = station 
el tribunal = court 
nativo = native 
la oposicion = opposition 
la panaderia = bakery 
exponer = to expound 
la temporada = timeframe 
loar = to laud 
redondo = round 
la magnitud = magnitude 
el director = director 
pasar = to pass 
amargo = bitter 
la virilidad = virility 
la comprobacion = revision 
el acompañante = companion 
la mermelada = jam 
el grado = rank 
la etapa = lap 
la enfermedad = disease 
el puerto = port 
el centro = center 
el trafico = traffic 
comodo = comfortable 
enfermo = ill 
bromear = to jest 
florido = blooming 
el campeonato = competition 
el plano = plane 
la distancia = distance 
la colaboracion = contribution 
imposible = impossible 
el extracto de cuenta = bank statement 
el canciller = chancellor 
el hospital = hospital 
dispuesto = ready 
el futuro = future 
el nivel = level 
el teatro = theatre 
la obra teatral = play 
la guia = ruler 
cristiano = christian 
el comprador = buyer 
comun = joint 
el derivativo = derivation 
el proyecto = project 
la corrida = heat 
la voluntad = will 
la lucha = wrestling 
enfermar = to be ill with 
la fuente = source 
la expresion = expression 
el ascensor = lift 
la refineria = refinery 
el interes = interest 
la especulacion = speculation 
la bomba = pump 
el contenido = content 
correr = to elapse 
la azafata = stewardess 
el aeropuerto = airport 
la cocina = kitchen 
la lluvia = rain 
el restaurante = restaurant 
mal = bad 
mucho = much 
activo = active 
limpio = clean 
importante = important 
extenso = extensive 
absoluto = absolute 
necesario = necessary 
la ambicion = ambition 
la oposicion = opposition 
los monumentos = sights 
moderado = moderate 
la crema = cream 
el estomago = stomach 
el promedio = average 
el mineral = mineral 
mineral = mineral 
el saber = knowledge 
conocido = known 
el abrigo = coat 
complicado = complicated 
razonable = senseful 
el instituto = institute 
Marruecos = Morocco 
cerrado = closed 
los mongolos = Mongolians 
abierto = open 
irrescatable = lost 
util = useful 
para = for 
el articulo = article 
la entrada = starter 
aceptable = acceptable 
el monto = amount 
sacro = holy 
el cafe = cafe 
el modismo = phrase 
la lucha = combat 
Meca = Mecca 
el climatizador = air condition 
la maquina = machine 
llenar = to fill 
favorable = providential 
la observacion = annotation 
el boxeo = boxing 
lugar de reunion = meeting point 
urgente = urgent 
la sal = salt 
campo de deportes = sports ground 
la cuchara = spoon 
real = royal 
mismo = equal 
la practica = exertion 
interesante = interesting 
el representante = deputy 
el borrador = rubber 
la enfermera = nurse 
lluvioso = rainy 
posible = possible 
aburrido = boring 
el reino = kingdom 
prohibido = forbidden 
el despertador = alarm 
el clima = climate 
la oportunidad = opportunity 
la discusion = discussion 
plano = flat 
el producto = product 
la sellecion = selection 
victorioso = victorious 
regular = regular 
deseado = desirable 
el oficio = function 
el area = area 
Mongolia = Mongolia 
el emigrante = emigrant 
la tarea = task 
la profesion = job 
sucio = dirty 
la secuela = sequel 
el ciudadano = citizen 
analogico = analogical 
la ola = wave 
el modelo = model 
el recurso = resource 
maquina de afeitar = razor 
el tema = topic 
objetivo = objective 
financiar = to finance 
la medalla = medal 
el presupuesto = budget 
la marca = characteristic 
la cita = appointment 
el nacimiento = birth 
afortunado = succesfull 
el antro = club 
equivaler = to match 
el editor = publisher 
el fan = fan 
discutir = to discuss 
el menos = minus 
el petrolero = tanker 
dormir = to sleep 
los mosquiteros = mosquitos 
la planta = plant 
ladrar = to bark 
el profeta = prophet 
el vino = wine 
el resultado = result 
resultar = to result 
la estrella = star 
la gramatica = grammar 
las datileras = date tree 
la rareza = rarity 
el seminario = seminar 
Noruega = Norway 
la cuota = rate 
la copia = copy 
los descendientes = descendants 
el texto = text 
el medio = half 
articular = to vocalize 
las gafas = glasses 
el regimen = regime 
el equivalente = equivalent 
si = yes 
el influjo = influence 
el sindicato = trade union 
el dinero = money 
la pintura = painting 
el transporte = transport 
transportar = to transport 
el chiste = joke 
crecer = to grow 
Austria = Austria 
el crecimiento = growth 
el dia = day 
el metodo = method 
la categoria = class 
emigrar = to emigrate 
bajar = to sink 
el ataque = attack 
apuntar = to aim 
el objetivo = aim 
el presente = gift 
huir = to flee 
la hormona = hormone 
la derrota = defeat 
India = India 
la ingeniera = engineering 
indio = indian 
el hobby = hobby 
Holanda = Holland 
la identidad = identity 
el comite = committee 
el oasis = oasis 
el ouad = wadi 
continuar = to continue 
acceder = to accede 
haber de = to must 
la existencia = existence 
decir adios = to see off 
tras = behind 
el papel = paper 
el ministerio = ministry 
la distincion = medal 
el medio = middle 
el poder = ability 
la prisa = hurry 
ordenar = to prescribe 
la descripcion = description 
la receta = recipy 
el recibo = receipt 
el estrato = location 
la gravedad = gravity 
la patria = home 
nacional = national 
prometer = to promise 
la promesa = promise 
la delegacion = delegation 
la plentitud = plenty 
la impertinencia = impertinence 
la profilaxis = prevention 
firmar = to sign 
el combustible = fuel 
el tutor = guardian 
desesperado = desperate 
japones = japanese 
Yemen = Yemen 
hoy = today 
diario = daily 
Grecia = Greece 
la nacionalidad = nationality 
la direccion = adress 
el número de teléfono = phone number 
correo electrónico = email 
el cargo = weight 
el ferro = anchor 
y = and 
Inglaterra = England 
agresivo = aggressive 
la piscina = swimming pool 
la subida = stairs 
el yodo = iodine 
el jubileo = jubilee 
el jurista = lawyer 
la ciudad = city 
el palo = stick 
la hija = daughter 
la hora = clock 
arbol de Navidad = Christmas Tree 
el vodka = vodka 
delgado = thin 
el mar = sea 
cocinar = to cook 
comprar = to buy 




